NO ./textures/north.png
SO ./textures/south.png
WE ./textures/west.png
EA ./textures/east.png
F 194,178,128
C 135,206,235

1111111111111111
1W00000000000001
1010S01000001111
1000000001001
1000111111111
10001
11111
