NO ./textures/north.png
SO ./textures/south.png
WE ./textures/west.png
EA ./textures/east.png

C 10,10,10
F 220,100,0
C 225,30,0

111111
110001
100N01
111111