NO ./textures/north.png
SO ./textures/south.png

F 220,100,0
WE ./textures/west.png
EA      ./textures/east.png
C 225,30,0

1 1 1 1 1 1
 10101010101
10101010101
11111111111