NO ./textures/north.png
SO ./textures/south.png
WE ./textures/west.png
EA

F 220,100,0
C 225,66,0

111111
110001
100N01
111111