NO ./path_to_the_north_texture
SO ./path_to_the_south_texture
F 220,100,0
WE ./path_to_the_west_texture
EA ./path_to_the_east_texture

C 225,30,0
F 10,10,10

111111
110001
100N01
111111