F 220,100,0
NO ./path_to_the_north_texture
SO ./path_to_the_south_texture
WE ./path_to_the_west_texture
C 225,30,0
EA ./path_to_the_east_texture

F 0,0,0
C 5,0,0

111111
110001
100N01
111111