NO ./path_to_the_north_texture
SO ./path_to_the_south_texture
WE ./path_to_the_west_texture
EA ./path_to_the_east_texture

F 220,240,0
C 214,10,888888888888888888

111111
110001
100N01
111111