NO ./textures/north.png
SO ./textures/south.png
WE ./textures/west.png
EA ./textures/east.png

F 220,100,0
C 225,30,0

111111111111111111
100000000000000001
100000000000000001
100000111111000001
100000100001000001
100000100001000001
100000000000000001
100000000000000001
10000000N000000001
100000000000000001
111111111111111111
