NO ./textures/StoneMoss-4220.png
SO ./textures/StoneMoss-4221.png
WE ./textures/StoneWall-4229.png
EA ./textures/StoneWall-4239.png

F 41,90,37
C 66,120,240
                                                                                                                                                                                                                             
                                                                                                                        111111111                  1111111111111 11111                  111111111111111111111111111111       
                                                                                      1111111111111111111111111111      100000001                  1000000000001 10001                  100000000000000000000000000001       
                                                                                      1000000000000000000000000001      100010001                  1000000000001 10001                  100000000000000000100000000001       
                                                                                      1000000000000001000000000001      100010001  11111           1000000000001 10111111111111111111111100000000000000000100000000001       
                                                                                      1000000000000001000000000001      100010001  10001           1000000000001 10000000000000000000000100000000000000000111111111111       
                                                                                      1000000000000001000000000001      100010001  10001           1000000000001 100000000000000000000001000000000000000001                  
                                                                                      1000000000000001000000000001      1000100011110111111111111111000000000001 100000000000000000000001000000000000000001                  
                                                                                      1000000000000001000000000001      1000100010000000000000000001000000000001 100000000000000000000000000000000000000001                  
                                                                                      1011111111111111000000000001      1111100010010000000000000001000000000001 11111111111111111111110001111111111111111111111             
                                                                                      10000001       1000000000001          100000010000000000000000000000000001    100000000000000000000000000000000000000000011111111111111
                                                                                      10000001       1000000000001          1111111111111111111111000111111111111111100000000000000000001000000000000000000000010000000000001
                                                   1111111111111111111111111111111111110000001     11111111111110111111111111110000000000000000000000000000000000000100000000000000000001000000000000000000000010000000000001
                                                   1000000000000000000000000000000000010000001     1000000000000000000000000001000000000000000000001000000000S000000100000000000000000001000000000000000000000010000000000001
                                                   1000000000000000000100000000000000010000001     10000000000000100000000000010000000000000000000010000000000000000000000000000000000001000000000000000000000010000000000001
                                                   1000000000000000000100000000000000010000001     10000000000000100000000000010000000000000000000011111111111111110111111111111111111111000000000000000000000010000000000001
                                                   1000000000000000000111111111111111011111111111111000000000000010000000000000000000000000000000001        100000001                   1000000000000000000000010000000000001
                                                   10000000000000000001          1000000000000000001000000000000011111111111101111111111111111111111        100000001                   1000000000000000000000010000000000001
                                                   10000000000000000001          100001000000000000100000000000001    1000000010000000000001                100000001                   1000000000000000000000000000000000001
                                                   10111111111111111111          100001000000000000000000000000001    1000000010000000000001                100000001                   1111111111111111111111011111111111111
                                                   100001   111111111111111111111101111111111111111111111111111111    1000000010000000000001                100000001                         100000000000000001001          
                                                   100001   100000000000000000000000001          111111               1000000010000000000001                100000001                         100000000000000001001          
                                                   100001   100000000000000000000100001          100001               1000000010000000000001    11111111111111111111111111111111111111111     100000000000000001111          
                                                   100001   10000000000000000000010000111        100001               1011111110000000000001    10000000000000000000000000000000000000001     100000000000000001             
                                                   100001   10000000000000000000010000001        10000111             100001  10000000000001    10000000000000000000000100000000000000001     100000000000000001             
                                                   100001   1000000000000000000001111000111      10000001             100001  10000000000001    10000000000000000000000100000000000000001     100000000000000001             
                                                  1111101   1011111111111111111111  1000001      111100011            100001  11111111111111    10000000000000000000000100000000000000001     100000000000000001             
                                                  1000001   1000000000001           1110001         100001            100001                    10000000000000000000000100000000000000001     100000000000000001             
                                                  1000001   1000000000001             10001         111001111111111111111101                    10111111111111111111111100000000000000001     101111111111111111111111       
                          1111111111111111111111111000001   1111111111101             10001           1001000000000000000001                    100001                 100000000000000001     100000000000000000000001       
                          1000000000000000000000001000001         1000001             1000111         1001000000000000000001                    100001                 111111111111111101     100000000000000000000001       
                          1000001000000000000000001000001         1000001             1000001         1000000000000000000001                    100001                  10000000000000001     100000000000000000000001       
                          1011111000000000000000001000001         1000001             11100011111111111111111111111111111111                    100001                  10000000000000001     100000000000000000000001       
                          1000011000000000000000001000001       111000001               1000000000000111111111111111111111111111111111111111111 100001                  10000000000000001     100000000000000000000001       
                          1000011000000000000000001000001       100000001               1110000000000100000000000000000000000000000000000000001 100001                  10000000000000001     100000000000000000000001       
                          1000011000000000000000000000001 111111100011111   1111111111111110000000000100000000000000000000010000000000000000001 100001                  10000000000000001     111111111111111111111111       
                          1000011111111111111111111111111 10000000001       1000000000000110000000000100000000000000000000010000000000000000001 100001                  10000000000000001                                    
                          100001                          10000000111       10000000001001100000000001000000000000000000000100000000000000000011111101                  10000000000000001                                    
                          100001                          10111111111111111110000000001001100000000001000000000000000000000100000000000000000010000001                  10000000000000001                                    
                          100001                          10000000000000000010000000001001100000000000000000000000000000000100000000000000000010000001                  10000000000000001       111111111111111111111        
        111111111111111111111101                          10000000000000000010000000001100011111111111111111111111111111111100000000000000000000000001                  1011111111111111111     100000000000000000001        
        100000000000000000000001                          1000000000000000001000000000110000001                            111111111111111111111111111                  1000000000000000001     100100000000000000001        
        100000000000000000000001                          1000000000000000001000000000111100001                                                                         1000000000000000001     100100000000000000001        
        100000000000000000000001                          10000000000000000010000000001  100001                                                                         1000000000000000001     100100000000000000001        
   11111100000000000000000000001                          10000000000000000000000000001  100001                                                                         1000000000000000001     100100000000000000001        
   10000100000000000000000000001                          11111111111111111111111111111  100001                                                                         1000000000000000001     100100000000000000001        
   10000000000000000000000000001                                                         10000111                                 11111111111111111111111111111111      1000000000000000001     100100000000000000001        
   11111111111111111111111111111                                                         10000001                                 10000000000000000000000000000001      100000000000000000111   100111111111111111101        
                                                                                         11110001111111                           10000000000010000000000000000001      100000000000000000001   1111       1000000001        
                                                                                            100000000011111111111111111111111111111000000000001000000000000000000111    111111111111111110001111111111111111000000001        
                                                                                            111000000010000000000000000000000000001000000000001000000000000000000001    100000000000000000100000000000000001000000001        
                                                                                              10000000100000000000000000000100000010000000000011111111111111111100011111100000000000000100100000000000000001000000001        
                                                                                              1000000010000000000000000000010000001000000000001                100000000100000000000000100100000000000000001000000001        
                                                                                              1000000010000000000000000000010000001000000000001                111000000000000000000000100100000000000000001000000001        
                                                                                              1000000000000000000000000000010000001000000000001                  1111111111111111111111100100000000000000001000000001        
                                                                                              1111111111111111111111111111110000000000000000001                                        100100000000000000001000000001        
                                                                                                                           11111111111111111111                                        100100000000000000000000000001        
                                                                                                                                                                                       100111111111111111111111111111        
                                                                                                                                                                                       1111                                  
