NO ./textures/north.png
SO ./textures/south.png
WE ./textures/west.png
EA ./textures/east.png
F 194,178,128
C 135,206,235

11111  111111                  1
10001  100001                 101
10001  110N01 1 1 1            1
10001   10001    1  111
10001   10001    1  101
11111   11111111101 101  11111111111111111111111
1111111111111111111 111



111111111111111111111111111111111111111111

    11111111111
1111 1 1 101 1
    11111111111

 1
1011
1011  11111
1011  10001
1011  10101
 1    10001
      11111





