NO ./textures/north.png
SO ./textures/south.png
WE ./textures/west.png
EA ./textures/east.png

F 220,100,0
C 225,30,0

  1111
 100S1
111111